Gene Name	Start	End	StartTruncated	EndTruncated	Length
5'UTR	1	575	1	0	574
CDS	576	7042	0	1	6466
1A	576	781	0	1	205
1B	783	1565	0	0	782
1C	1566	2279	0	0	713
1D	2280	3146	0	0	866
2A	3147	3575	0	0	428
2B	3576	3860	0	0	284
2C	3861	4823	0	0	962
3A	4824	5057	0	0	233
3B	5058	5120	0	0	62
3C	5121	5669	0	0	548
3D	5670	7042	0	1	1372