Gene Name	Start	End	StartTruncated	EndTruncated	Length
5'UTR	1	575	1	0	574
CDS	576	7052	0	0	6476
1A	576	776	0	1	200
1B	783	1563	0	1	780
1C	1569	2282	0	0	713
1D	2283	3149	0	0	866
2A	3150	3578	0	0	428
2B	3579	3863	0	0	284
2C	3864	4826	0	0	962
3A	4827	5060	0	0	233
3C	5124	5672	0	0	548
3D	5673	7042	0	1	1369
3'UTR	7055	7093	1	0	38