Gene Name	Start	End	StartTruncated	EndTruncated	Length
5'UTR	1	570	1	0	569
CDS	571	7047	0	0	6476
1A	571	771	0	1	200
1B	778	1558	0	1	780
1C	1564	2277	0	0	713
1D	2278	3144	0	0	866
2A	3145	3573	0	0	428
2B	3574	3858	0	0	284
2C	3859	4821	0	0	962
3A	4822	5055	0	0	233
3C	5119	5667	0	0	548
3D	5668	7037	0	1	1369
3'UTR	7050	7081	1	1	31