Gene Name	Start	End	StartTruncated	EndTruncated	Length
5'UTR	1	518	1	0	517
CDS	519	6968	0	0	6449
1A	519	725	0	0	206
1B	726	1504	0	1	778
1C	1506	2215	0	1	709
1D	2217	3065	0	0	848
2A	3066	3491	0	0	425
2B	3492	3776	0	0	284
2C	3777	4738	0	1	961
3A	4743	4972	0	1	229
3C	5037	5581	0	1	544
3D	5586	6965	0	0	1379
3'UTR	6969	7001	0	1	32