Gene Name	Start	End	StartTruncated	EndTruncated	Length
5'UTR	1	573	1	0	572
CDS	574	7056	0	0	6482
1A	574	780	0	0	206
1B	781	1566	0	0	785
1C	1567	2280	0	0	713
1D	2281	3156	0	0	875
2A	3157	3584	0	1	427
2C	3871	4831	0	1	960
3C	5128	5669	0	1	541
3D	5713	7053	1	0	1340