Gene Name	Start	End	StartTruncated	EndTruncated	Length
5'UTR	1	588	1	0	587
CDS	589	7083	0	0	6494
1A	589	794	0	1	205
1B	796	1587	0	0	791
1C	1588	2301	0	0	713
1D	2302	3180	0	0	878
2A	3181	3609	0	0	428
2B	3610	3894	0	0	284
2C	3895	4857	0	0	962
3A	4858	5087	0	1	229
3B	5092	5154	0	0	62
3C	5155	5703	0	0	548
3D	5705	7080	0	0	1375