Gene Name	Start	End	StartTruncated	EndTruncated	Length
5'UTR	1	571	1	0	570
CDS	572	7047	0	1	6475
1A	572	778	0	0	206
1B	779	1560	0	1	781
1C	1568	2281	0	0	713
1D	2282	3138	0	1	856
2A	3146	3571	0	0	425
2B	3572	3843	0	1	271
2C	3857	4821	0	1	964
3A	4823	5053	0	0	230
3B	5054	5112	0	1	58
3C	5117	5665	0	0	548
3D	5666	7045	0	0	1379