Gene Name	Start	End	StartTruncated	EndTruncated	Length
5'UTR	1	535	1	0	534
CDS	536	7006	0	0	6470
1A	536	742	0	0	206
1B	743	1531	0	0	788
1C	1532	2242	0	0	710
1D	2243	3103	0	0	860
2A	3104	3529	0	0	425
2B	3530	3814	0	0	284
2C	3815	4779	0	1	964
3B	5012	5074	0	0	62
3C	5075	5623	0	0	548
3D	5624	7003	0	0	1379
3'UTR	7007	7043	0	0	36